{
	"main": {
		"layout"  : [
		[1, 0, 1, 1, 0, 1, 1, 1, 1, 1, 1, 1, 1, 1, 1, 1, 1, 1, 1, 4],
		[3, 0, 3, 3, 0, 3, 3, 3, 3, 3, 3, 3, 3, 3, 3, 3, 3, 3, 3, 5],
		[6, 0, 0, 0, 0, 0, 0, 0, 0, 0, 0, 0, 0, 0, 0, 0, 0, 0, 0, 2],
		[6, 0, 0, 0, 0, 0, 0, 0, 0, 0, 0, 0, 0, 0, 0, 0, 0, 0, 0, 2],
		[6, 0, 0, 0, 0, 0, 0, 0, 0, 0, 0, 0, 0, 0, 0, 0, 0, 0, 0, 2],
		[6, 0, 0, 0, 2, 1, 1, 1, 1, 1, 1, 1, 1, 1, 1, 4, 0, 0, 0, 2],
		[6, 0, 0, 0, 2, 0, 0, 0, 0, 0, 0, 0, 0, 0, 0, 6, 0, 0, 0, 2],
		[6, 0, 0, 0, 2, 0, 0, 0, 0, 0, 0, 0, 0, 0, 0, 6, 0, 0, 0, 2],
		[6, 0, 0, 0, 2, 0, 0, 0, 0, 0, 0, 0, 0, 0, 0, 6, 0, 0, 0, 2],
		[6, 0, 0, 0, 2, 0, 0, 0, 0, 0, 0, 0, 0, 0, 0, 6, 0, 0, 0, 2],
		[6, 0, 0, 0, 2, 0, 0, 0, 0, 0, 0, 0, 0, 0, 0, 6, 0, 0, 0, 2],
		[6, 0, 0, 0, 2, 0, 0, 0, 0, 0, 0, 0, 0, 0, 0, 6, 0, 0, 0, 2],
		[6, 0, 0, 0, 2, 0, 0, 0, 0, 0, 0, 0, 0, 0, 0, 6, 0, 0, 0, 2],
		[6, 0, 0, 0, 2, 0, 0, 0, 0, 0, 0, 0, 0, 0, 0, 6, 0, 0, 0, 2],
		[6, 0, 0, 0, 2, 0, 0, 0, 0, 0, 0, 0, 0, 0, 0, 6, 0, 0, 0, 2],
		[6, 0, 0, 0, 1, 1, 1, 1, 1, 1, 1, 1, 1, 1, 1, 1, 0, 0, 0, 2],
		[6, 0, 0, 0, 3, 3, 3, 3, 3, 3, 3, 3, 3, 3, 3, 3, 0, 0, 2],
		[6, 0, 0, 0, 0, 0, 0, 0, 0, 0, 0, 0, 0, 0, 0, 0, 0, 0, 0, 2],
		[6, 0, 0, 0, 0, 0, 0, 0, 0, 0, 0, 0, 0, 0, 0, 0, 0, 0, 0, 2],
		[6, 0, 0, 0, 0, 0, 0, 0, 0, 0, 0, 0, 0, 0, 0, 0, 0, 0, 0, 2],
		[1, 1, 1, 1, 1, 1, 1, 1, 1, 1, 1, 1, 1, 1, 1, 1, 1, 1, 1, 1]
	],
	"teleporters" : [
		{ "x" : 1, "y" : 0, "go_to_map" : "k133" , "go_to_x" : 1, "go_to_y" : 5},
		{ "x" : 4, "y" : 0, "go_to_map" : "k133" , "go_to_x" : 4, "go_to_y" : 5}
	],
	"player" :{ "x" : 1, "y" : 1}
},


	"k133" : { "layout" :[
		[1,1,1,1,1,1],
		[1,0,0,0,0,1],
		[1,0,0,0,0,1],
		[1,0,0,0,0,1],
		[1,0,0,0,0,1],
		[1,0,1,1,0,1]
	],
	"teleporters" : [
		{ "x" : 1, "y" : 5, "go_to_map" : "main","go_to_x" : 1, "go_to_y" : 1},
		{ "x" : 4, "y" : 5, "go_to_map" : "main","go_to_x" : 4, "go_to_y" : 1}
	]
	}
	


}