{
	"main": {
		"layout"  : [
		[7, 1, 0, 1, 1, 0, 1, 1, 1, 1, 1, 1, 1, 1, 1, 1, 1, 1, 1, 4],
		[8, 3, 0, 3, 3, 0, 3, 3, 3, 3, 3, 3, 3, 3, 3, 3, 3, 3, 3, 5],
		[6, 0, 0, 0, 0, 0, 0, 0, 0, 0, 0, 0, 0, 0, 0, 0, 0, 0, 0, 2],
		[6, 0, 0, 0, 0, 0, 0, 0, 0, 0, 0, 0, 0, 0, 0, 0, 0, 0, 0, 2],
		[6, 0, 0, 0, 0, 0, 0, 0, 0, 0, 0, 0, 0, 0, 0, 0, 0, 0, 0, 2],
		[6, 0, 0, 0, 2, 1, 1, 1, 1, 1, 1, 1, 1, 1, 1, 6, 0, 0, 0, 2],
		[6, 0, 0, 0, 2, 10, 10, 10, 10, 10, 10, 10, 10, 10,10, 6, 0, 0, 0, 2],
		[6, 0, 0, 0, 2, 10, 10, 10, 10, 10, 10, 10, 10, 10, 10,6, 0, 0, 0, 2],
		[6, 0, 0, 0, 2, 10, 10, 10, 10, 10, 10, 10, 10, 10, 10,6, 0, 0, 0, 2],
		[6, 0, 0, 0, 2, 10, 10, 10, 10, 10, 10, 10, 10, 10, 10,6, 0, 0, 0, 2],
		[6, 0, 0, 0, 2, 10, 10, 10, 10, 10, 10, 10, 10, 10, 10,6, 0, 0, 0, 2],
		[6, 0, 0, 0, 2, 10, 10, 10, 10, 10, 10, 10, 10, 10, 10,6, 0, 0, 0, 2],
		[6, 0, 0, 0, 2, 10, 10, 10, 10, 10, 10, 10, 10, 10, 10,6, 0, 0, 0, 2],
		[6, 0, 0, 0, 2, 10, 10, 10, 10, 10, 10, 10, 10, 10,10, 6, 0, 0, 0, 2],
		[6, 0, 0, 0, 2, 10, 10, 10, 10, 10, 10, 10, 10, 10,10, 6, 0, 0, 0, 2],
		[6, 0, 0, 0, 1, 1, 1, 1, 1, 1, 1, 1, 1, 1, 1, 1, 0, 0, 0, 2],
		[6, 0, 0, 0, 3, 3, 3, 3, 3, 3, 3, 3, 3, 3, 3, 3, 0, 0, 0, 2],
		[6, 0, 0, 0, 0, 0, 0, 0, 0, 0, 0, 0, 0, 0, 0, 0, 0, 0, 0, 2],
		[6, 0, 0, 0, 0, 0, 0, 0, 0, 0, 0, 0, 0, 0, 0, 0, 0, 0, 0, 2],
		[6, 0, 0, 0, 0, 0, 0, 0, 0, 0, 0, 0, 0, 0, 0, 0, 0, 0, 0, 2],
		[1, 1, 1, 1, 1, 1, 1, 1, 1, 1, 1, 1, 1, 1, 1, 1, 1, 1, 1, 1]
	],
	"teleporters" : [
		{ "x" : 2, "y" : 0, "go_to_map" : "k133" , "go_to_x" : 7, "go_to_y" : 5},
		{ "x" : 5, "y" : 0, "go_to_map" : "k133" , "go_to_x" : 10, "go_to_y" : 5}
	],
	"player" :{ "x" : 2, "y" : 2}
},


	"k133" : { "layout" :[
		[7,1,1,1,1,1,1,1,1,1,1,4],
		[8,3,3,3,3,3,3,3,3,3,3,5],
		[6,0,9,0,9,0,9,0,9,0,0,2],
		[6,0,9,0,9,0,9,0,9,0,0,2],
		[6,0,0,0,0,0,0,0,0,0,0,2],
		[6,0,9,0,9,0,0,0,9,0,0,2],
		[1,1,1,1,1,1,1,0,1,1,0,1]
	],
	"teleporters" : [
		{ "x" : 7, "y" : 6, "go_to_map" : "main","go_to_x" : 2, "go_to_y" : 1},
		{ "x" : 10, "y" : 6, "go_to_map" : "main","go_to_x" : 5, "go_to_y" : 1}
	]
	}
	


}